777777777777777
711104666401117
711106666601117
711104666401117
711100060001117
711111111111117
710100010001017
710101111101017
710101000101017
710101000101017
711111111111117
710101000101017
710101000101017
710101111101017
710100010001017
710100010001017
710101111101017
710101000101017
710101000101017
711111111111117
710101000101017
710101000101017
710101111101017
710100010001017
711111121111117
777777777777777
