7777777777777777777777777777777
7111111111110466640111111111117
7100101000010666660100001010017
7100101111110466640111111010017
7100100000010006000100000010017
7100111111011111111101111110017
7111110101000001000001010111117
7100010111011111111101110100017
7100010101010010100101010100017
7111111101111110111111011111117
7100010101010000000101010100017
7111010101011110111101010101117
7101010101000010100001010101017
7101010101011112111101010101017
7111111111110011100111111111117
7777777777777777777777777777777