0000000000000000000000000000000
0111111111110411140111111111110
0100101000010111110100001010010
0100101111110411140111111010010
0100100000010001000100000010010
0100111111011111111101111110010
0111110101000001000001010111110
0100010111011111111101110100010
0100010101010010100101010100010
0111111101111110111111011111110
0100010101010000000101010100010
0111010101011110111101010101110
0101010101000010100001010101010
0101010101011112111101010101010
0111111111110011100111111111110
0000000000000000000000000000000