77777777777777777777777777777777777777777
71111111111111100000000000111111111111117
71010100100000111111111111100100100000017
71010100111111100000000000100100111111117
71010100100000111111011111100100100000017
71111111111111100001010000111111111111117
71000000000000101111111110100000000000017
71111111111111101000600010111111111111117
71000000000010101046664010101000000000017
71011111111110111066666011101011111111117
71111111111010101046664010101111111111017
71000000000010101000000010101000000000017
71111111111111111111111111111111111111117
71000000100000100000000000100000100000017
71000000100000100111011100100000100000017
71000000100000100101010100100000100000017
71111111111111111101210111111111111111117
77777777777777777777777777777777777777777