000000000000000
011104666401110
011106666601110
011104666401110
011100060001110
011111111111110
010100010001010
010101111101010
010101000101010
010101000101010
011111111111110
010101000101010
010101000101010
010101111101010
010100010001010
010100010001010
010101111101010
010101000101010
010101000101010
011111111111110
010101000101010
010101000101010
010101111101010
010100010001010
011111121111110
000000000000000
