000000000000000
011104555401110
011105555501110
011104555401110
011100050001110
011111111111110
010100010001010
010101111101010
010101000101010
010101000101010
011111111111110
010101000101010
010101000101010
010101111101010
010100010001010
010100010001010
010101111101010
010101000101010
010101000101010
011111111111110
010101000101010
010101000101010
010101111101010
010100010001010
011111121111110
000000000000000
