00000000000000000000000000000000000000000
01111111111111100000000000111111111111110
01010100100000111111111111100100100000010
01010100111111100000000000100100111111110
01010100100000111111011111100100100000010
01111111111111100001010000111111111111110
01000000000000101111111110100000000000010
01111111111111101000500010111111111111110
01000000000010101045554010101000000000010
01011111111110111055555011101011111111110
01111111111010101045554010101111111111010
01000000000010101000000010101000000000010
01111111111111111111111111111111111111110
01000000100000100000000000100000100000010
01000000100000100111011100100000100000010
01000000100000100101010100100000100000010
01111111111111111101210111111111111111110
00000000000000000000000000000000000000000