0000000000000000000000000000000
0111111000010511150100001111110
0000101000010111110100001010000
0000101111110511150111111010000
0000100000010001000100000010000
0000111111011111111101111010000
0111110101000001000000101111110
0000010111011111111101111100000
0000010101010010100101010100000
0111111101111110111111011111110
0100010101010000000101010100010
0111010101011110111101010101110
0101010101000010100001010101010
0101010111011111111101110101010
0101111111100112100111111111010
0000000000000000000000000000000